9 9
255 255 255 255 255 255 255 255 255
255 255 63 255 0 255 255 255 255
255 255 255 0 255 255 255 255 255
255 191 255 255 191 255 255 63 255
255 255 255 255 1 63 255 127 1
1 255 0 255 255 0 1 255 255
255 255 0 0 63 255 255 255 255
255 191 255 127 255 0 255 127 255
255 255 255 255 255 255 255 255 255